хлеб - bread
молоко - milk
сыр - cheese
картофель - potato
огурец - cucumber
помидор - tomato
яйцо - egg
курица - chicken
говядина - beef
свинина - pork
рыба - fish
морепродукты - seafood
суп - soup
салат - salad
масло - butter
рис - rice
макароны - pasta
чеснок - garlic
лук - onion
грибы - mushrooms
бекон - bacon
колбаса - sausage
хот-дог - hot dog
гамбургер - hamburger
пицца - pizza
блины - pancakes
шоколад - chocolate
печенье - cookies
торт - cake
пирог - pie
сок - juice
чай - tea
кофе - coffee
вода - water
вино - wine
пиво - beer
лимонад - lemonade
смузи - smoothie
мороженое - ice cream
сахар - sugar
соль - salt
перец - pepper
специи - spices
уксус - vinegar
кетчуп - ketchup
горчица - mustard
майонез - mayonnaise
зерно - grain
крупа - cereal
фасоль - beans
чечевица - lentils
орехи - nuts
мед - honey
джем - jam
конфеты - candies
пудинг - pudding
варенье - preserve
кексы - muffins
крекеры - crackers
чипсы - chips
сендвич - sandwich
креветки - shrimps
лосось - salmon
тунец - tuna
кальмары - squids
мидии - mussels
устрицы - oysters
осьминоги - octopuses
водоросли - seaweed
икра - caviar
крабы - crabs
лапша - noodles
пельмени - dumplings
вареники - pierogi
борщ - borscht
шашлык - kebab
плов - pilaf
солянка - solyanka
окрошка - okroshka
рулет - roulade
шницель - schnitzel
стейк - steak
бифштекс - beefsteak
рагу - ragout
гуляш - goulash
бульон - broth
гранат - pomegranate
апельсин - orange
банан - banana
яблоко - apple
груша - pear
виноград - grapes
клубника - strawberry
малина - raspberry
черника - blueberry
арбуз - watermelon
дыня - melon
кабачок - zucchini
баклажан - eggplant
тыква - pumpkin