паспорт - passport
билет - ticket
регистрация - check-in
рейс - flight
отпуск - vacation
виза - visa
чемодан - suitcase
аэропорт - airport
отель - hotel
пляж - beach
таможня - customs
багаж - luggage
турист - tourist
экскурсия - excursion
гид - guide
карта - map
путеводитель - guidebook
фотоаппарат - camera
сувенир - souvenir
памятник - monument
страховка - insurance
путешествие - journey
остановка - stop
направление - direction
прибытие - arrival
отправление - departure
загранпаспорт - foreign passport
поезд - train
автобус - bus
трамвай - tram
метро - subway
такси - taxi
корабль - ship
паром - ferry
круиз - cruise
тур - tour
пешком - on foot
велосипед - bicycle
аренда - rental
бронирование - booking
номер - room
заселение - check-in (hotel)
выселение - check-out (hotel)
двухместный номер - double room
одноместный номер - single room
местный - local
международный - international
рюкзак - backpack
консульство - consulate
граница - border
пограничник - border guard
досмотр - inspection
декларация - declaration
посольство - embassy
поход - hike
лагерь - camp
палатка - tent
костер - campfire
звезды - stars
горы - mountains
река - river
озеро - lake
море - sea
океан - ocean
пустыня - desert
джунгли - jungle
сафари - safari
приключение - adventure
культура - culture
традиция - tradition
местный житель - local resident
курорт - resort
расписание - schedule
питание - meals
завтрак - breakfast
обед - lunch
ужин - dinner
бюджет - budget
расходы - expenses
валюта - currency
обмен - exchange
курс - rate
чек - check
недорого - inexpensive
дорого - expensive
пакет - package
документы - documents
пропуск - permit
скидка - discount
купон - coupon
завершение - conclusion
начало - beginning
комфорт - comfort
удобство - convenience
проживание - accommodation
хобби - hobby
путешествие - journey
туристическая достопримечательность - tourist attraction
осмотр достопримечательностей - sightseeing
место назначения - destination
